1111111111111
10010000000C1
1000011111000
100011E000001
1111111111111
